11111111111111111111111111
10000000000100000000000001
11111100000C00000000011111
10000000000000000000000001
10000000001010110000000001
10000000000E00000100000101
10000000000001010000000001
10000000000000000000000001
1010000000000P000000000001
11111111111111111111111111